      read – читать
      write – писать
      listen to – слушать
      watch – смотреть
      make – создавать (делать)
      do – делать
      cook - готовить
      answer – отвечать
      become – становиться
    play – играть
    live – жить
    travel – путешествовать
    like – нравится
    give – давать
    want – хотеть
    go – идти
    think – думать
    take – брать
    get – получать
    come – приходить
    see – видеть
    find -находить
    feel – чувствовать
    know – знать
    learn – учить
    study – учить
    help – помогать
    say – говорить
    hear – слышать
     Day – день
     Night – ночь
     Week – неделя
     Year – год
     Month – месяц
     Child - ребенок
     World – мир
     Family – семья
     Parents – родители
     Brother – брат
     Sister – сестра
     Home -дом
     Mother – мама
     Father – папа
     Friend – друг
     Small – маленький
     Big – большой
     Short – короткий
     Long – длинный
     Beautiful -красивый
     Ugly – страшный
     Strange – странный
     Comfortable – комфортный
     Easy – легкий
     Difficult – сложный
     Always -всегда
     Never – никогда
     Old – старый
     New – новый
     Here – здесь
     There – там
     Street - улица
     River – река
     Breakfast – завтрак
     Dinner – ужин
     Meat – мясо
     Bread – хлеб
     Milk – молоко
     Tea – чай
     Water – вода
     Advice - совет
     Any – любой
     Clothes – одежда
     Colour – цвет
     Paper – бумага
     School – школа
     Teacher – учитель
     University – университет
     Job – работа
     Flower – цветок
     Grass – трава
     Sky – небо
     Evening – вечер
     Morning – утро
     When – когда
     Which – который
     Where – где
     How - как
     Can – мочь
     Need – нуждаться
     Should – следует
     Picture – картина
     Theater – театр
     Money – деньги
     Between – между
     Over – над
     Again – снова
     Warm – тепло
     Cold – холодно
     Today – сегодня
     Yesterday – вчера
